5 10
|--------|
|FFF|....|
|......P.|
|FF...@|.|
|--------|
