5 10
|--------|
|.O.|..-.|
|..-|.@..|
|.O....-.|
|--------|